#####################
#a#  b#             #
# ### ####### # # # #
#        B#  C# # # #
### ##### ### # #####
#   # # #     #     #
##### # ##### ### ###
#     f  E      #   #
# ######### #######d#
# # # #       # # # #
### # # # ### # # # #
# # c   #   # #     #
# ##### ####### ### #
#      DF     # #   #
# ### # # # # # # # #
# #   # # # # # # # #
### # ### ### # ### #
#   # #    g# #   # #
# # #e### ##### # #G#
# # #   #   #   # #h#
#####################